的	e
我	i
是	u
不	r
了	o
在	w
当	sw
中	ki
啊	ji
哦	kgw
吧	kge
叭	kgr
哈	gw
那	xi
去	po
所	so
只	si
等	pi
呢	kdw
下	lfe
地	psi
左	aki
应	flu
展	mfw
告	mdw
快	hdw
领	cpe
林	ttr
往	fne
亲	jsu
争	fdo
花	cjw
流	hso
满	hke
跟	xfi
影	vdo
落	chw
坐	apu
紧	vyo
哪	cxi
怪	hpu
宝	gni
实	gkyi
单	jdzu
半	jdsu
急	fadu
率	jlaw
校	tlso
嘴	kvai