的	e
是	u
不	r
了	o
在	w
我	i
中	ki
地	psi
那	xi
下	lfe
所	so
去	po
只	si
当	sw
实	gkyi
等	pi
应	flu
展	mfw
告	mdw
呢	kdw
快	hdw
领	cpe
林	ttr
往	fne
亲	jsu
吧	kge
争	fdo
流	hso
满	hke
跟	xfi
影	vdo
单	jdzu
半	jdsu
啊	ji
落	chw
坐	apu
紧	vyo
哪	cxi
急	fadu
左	aki
率	jlaw
哈	gw
校	tlso
怪	hpu
宝	gni
嘴	kvai
哦	kgw
叭	kgr